11111111111111111111111111111
10000000000000000000000000001
11111111111100011111111111111
10C0P0000E0100010000000000001
10111111111100011111111111101
10100000000000000000000000101
10111111111100011111111111101
10000010000000000000001000001
10111110000000000000001111101
10100000000000000000000000101
10100000000000000000000000101
10100000000000000000000000101
10111111000000000000011111101
10000000000000000000000000001
10000000000000000000000000001
11111111111111111111111111111
